{
  "width": 40,
  "height": 36,
  "tileset": "001_MainTileset",
  "tiles": [
    25, 25, 25, 25, 25, 26, 14, 14, 14, 14, 14, 14, 14, 14, 14, 14, 7, 0, 2, 2, 14, 14, 14, 14, 14, 14, 14, 14, 14, 14, 14, 14, 14, 14, 14, 14, 14, 14, 14, 14,
    25, 25, 25, 25, 25, 26, 14, 14, 14, 14, 14, 14, 14, 14, 14, 14, 7, 0, 2, 4, 14, 14, 14, 14, 14, 14, 14, 14, 14, 14, 14, 14, 14, 14, 14, 14, 14, 14, 14, 14,
    25, 25, 25, 25, 25, 26, 14, 14, 14, 14, 14, 14, 14, 14, 14, 14, 7, 0, 1, 0, 14, 14, 14, 14, 2, 2, 2, 2, 2, 2, 2, 2, 2, 2, 2, 2, 14, 14, 14, 14,
    25, 25, 25, 25, 25, 26, 14, 14, 14, 14, 14, 14, 14, 14, 14, 14, 7, 0, 0, 1, 14, 14, 14, 14, 2, 2, 2, 2, 2, 2, 2, 2, 2, 2, 2, 2, 14, 14, 14, 14,
    25, 25, 25, 25, 25, 26, 8, 8, 8, 8, 8, 8, 8, 8, 15, 8, 1, 0, 1, 0, 1, 0, 2, 2, 2, 2, 2, 2, 272, 273, 273, 273, 273, 274, 2, 2, 14, 14, 14, 14,
    25, 25, 25, 25, 25, 26, 8, 8, 6, 6, 6, 6, 6, 6, 14, 14, 0, 1, 0, 1, 0, 1, 2, 2, 2, 2, 2, 2, 245, 246, 246, 246, 246, 247, 2, 2, 14, 14, 14, 14,
    25, 25, 25, 25, 25, 26, 8, 6, 14, 14, 14, 14, 14, 14, 14, 14, 7, 0, 1, 0, 7, 0, 2, 2, 2, 2, 2, 2, 280, 281, 296, 297, 281, 282, 2, 2, 14, 14, 14, 14,
    25, 25, 25, 25, 25, 26, 8, 6, 14, 14, 14, 14, 14, 14, 14, 14, 7, 0, 0, 1, 7, 0, 2, 2, 2, 2, 2, 4, 288, 289, 289, 289, 251, 290, 2, 2, 14, 14, 14, 14,
    25, 25, 25, 25, 25, 26, 8, 6, 14, 14, 14, 14, 14, 14, 14, 14, 7, 0, 1, 0, 248, 249, 249, 250, 2, 2, 2, 2, 8, 8, 8, 8, 8, 8, 2, 2, 14, 14, 14, 14,
    25, 25, 25, 25, 25, 26, 8, 6, 14, 14, 14, 14, 14, 14, 14, 14, 7, 0, 0, 1, 256, 251, 264, 258, 102, 102, 102, 102, 44, 44, 44, 44, 44, 44, 102, 102, 14, 14, 14, 14,
    25, 25, 25, 25, 25, 26, 8, 6, 14, 14, 14, 14, 14, 14, 14, 14, 7, 0, 1, 0, 1, 0, 1, 0, 1, 0, 1, 0, 1, 0, 1, 0, 1, 0, 2, 2, 14, 14, 14, 14,
    25, 25, 25, 25, 25, 26, 8, 6, 14, 14, 14, 14, 14, 14, 14, 14, 7, 0, 0, 1, 0, 1, 0, 1, 0, 1, 0, 1, 0, 1, 0, 1, 0, 1, 2, 2, 14, 14, 14, 14,
    25, 25, 25, 25, 25, 26, 8, 6, 14, 14, 14, 14, 14, 14, 14, 14, 7, 0, 1, 0, 2, 2, 2, 2, 2, 2, 2, 2, 2, 2, 2, 2, 2, 2, 2, 2, 14, 14, 14, 14,
    33, 33, 33, 33, 33, 34, 8, 6, 14, 14, 14, 14, 14, 14, 14, 14, 7, 0, 0, 1, 7, 7, 7, 7, 7, 7, 7, 7, 7, 7, 7, 7, 7, 7, 7, 7, 14, 14, 14, 14,
    8, 8, 8, 8, 8, 8, 8, 6, 14, 14, 14, 14, 14, 14, 14, 14, 7, 0, 1, 0, 248, 249, 249, 250, 1, 0, 1, 0, 1, 0, 1, 0, 1, 0, 1, 0, 8, 8, 8, 8,
    8, 8, 8, 8, 8, 8, 8, 6, 14, 14, 14, 14, 14, 14, 14, 14, 7, 1, 0, 1, 256, 251, 264, 258, 0, 1, 0, 1, 0, 1, 0, 1, 0, 1, 0, 1, 8, 8, 8, 8,
    2, 2, 1, 0, 1, 0, 8, 8, 14, 14, 14, 14, 14, 14, 14, 14, 2, 2, 1, 0, 2, 2, 2, 2, 1, 0, 8, 8, 252, 253, 253, 254, 8, 8, 1, 0, 14, 14, 14, 14,
    2, 2, 0, 1, 0, 1, 8, 8, 8, 8, 8, 8, 8, 8, 8, 8, 2, 4, 0, 1, 7, 7, 7, 7, 0, 1, 8, 8, 268, 269, 269, 270, 8, 8, 0, 1, 14, 14, 14, 14,
    17, 17, 17, 20, 1, 0, 1, 0, 1, 0, 1, 0, 1, 0, 1, 0, 1, 0, 1, 0, 8, 8, 8, 8, 1, 0, 8, 8, 285, 255, 255, 287, 8, 8, 1, 0, 14, 14, 14, 14,
    25, 25, 25, 26, 0, 1, 0, 1, 0, 1, 0, 1, 0, 1, 0, 1, 0, 1, 0, 1, 8, 8, 8, 8, 0, 1, 8, 8, 292, 251, 279, 294, 8, 8, 0, 1, 14, 14, 14, 14,
    25, 25, 25, 26, 1, 0, 8, 8, 8, 8, 8, 8, 8, 8, 8, 8, 1, 0, 1, 0, 1, 0, 1, 0, 1, 0, 1, 0, 1, 0, 1, 0, 1, 0, 1, 0, 14, 14, 14, 14,
    25, 25, 25, 26, 14, 14, 14, 14, 8, 8, 8, 8, 8, 8, 8, 8, 0, 1, 0, 1, 0, 1, 0, 1, 0, 1, 0, 1, 0, 1, 0, 1, 0, 1, 0, 1, 14, 14, 14, 14,
    25, 25, 25, 26, 1, 0, 8, 8, 15, 8, 8, 8, 8, 8, 8, 8, 1, 0, 8, 8, 1, 0, 252, 253, 253, 254, 1, 0, 8, 8, 8, 8, 8, 8, 1, 0, 14, 14, 14, 14,
    25, 25, 25, 26, 0, 1, 8, 8, 14, 14, 8, 8, 8, 8, 8, 8, 0, 1, 8, 8, 0, 1, 268, 269, 269, 270, 0, 1, 8, 8, 8, 8, 8, 8, 0, 1, 14, 14, 14, 14,
    25, 25, 25, 26, 1, 0, 8, 8, 138, 153, 153, 153, 153, 136, 8, 8, 1, 0, 8, 8, 1, 0, 285, 255, 255, 287, 1, 0, 8, 8, 8, 8, 8, 8, 1, 0, 14, 14, 14, 14,
    25, 25, 25, 26, 0, 1, 8, 8, 146, 145, 145, 145, 145, 144, 8, 8, 0, 1, 8, 8, 0, 1, 292, 251, 271, 294, 0, 1, 8, 8, 8, 8, 8, 8, 0, 1, 14, 14, 14, 14,
    25, 25, 25, 26, 2, 2, 8, 8, 146, 145, 145, 145, 145, 144, 8, 8, 2, 2, 8, 8, 2, 2, 2, 2, 2, 2, 2, 2, 2, 2, 2, 2, 2, 2, 2, 2, 14, 14, 14, 14,
    33, 33, 33, 34, 102, 102, 44, 44, 146, 145, 145, 145, 145, 144, 44, 36, 102, 102, 44, 36, 102, 102, 102, 102, 102, 102, 102, 102, 102, 102, 102, 102, 102, 102, 102, 102, 14, 14, 14, 14,
    8, 8, 8, 6, 1, 0, 8, 8, 8, 8, 8, 8, 8, 8, 8, 8, 1, 0, 8, 8, 0, 0, 0, 0, 0, 0, 0, 0, 0, 0, 0, 0, 0, 0, 0, 0, 14, 14, 14, 14,
    8, 8, 8, 6, 0, 1, 8, 8, 8, 8, 8, 8, 8, 8, 8, 8, 0, 1, 8, 8, 0, 0, 0, 0, 0, 1, 0, 0, 0, 0, 0, 0, 0, 0, 0, 0, 14, 14, 14, 14,
    8, 8, 8, 6, 2, 2, 2, 2, 2, 2, 2, 2, 2, 2, 2, 2, 2, 2, 2, 2, 0, 0, 0, 0, 0, 0, 0, 0, 0, 0, 0, 0, 0, 0, 0, 0, 14, 14, 14, 14,
    8, 8, 8, 6, 7, 7, 7, 7, 7, 7, 7, 7, 7, 7, 7, 7, 7, 0, 1, 7, 7, 7, 7, 7, 7, 7, 7, 7, 7, 7, 7, 7, 7, 7, 7, 7, 14, 14, 14, 14,
    8, 8, 8, 8, 8, 8, 8, 8, 8, 8, 6, 8, 8, 8, 8, 8, 6, 1, 0, 6, 8, 8, 8, 8, 8, 6, 8, 8, 8, 8, 8, 8, 8, 8, 8, 8, 14, 14, 14, 14,
    8, 8, 8, 8, 8, 8, 8, 8, 8, 8, 6, 8, 8, 8, 8, 8, 6, 0, 1, 6, 8, 8, 8, 8, 8, 6, 8, 8, 8, 8, 8, 8, 8, 8, 8, 8, 14, 14, 14, 14,
    8, 8, 8, 8, 8, 8, 8, 8, 8, 8, 6, 8, 8, 8, 8, 8, 6, 1, 0, 6, 8, 8, 8, 8, 8, 6, 8, 8, 8, 8, 8, 8, 8, 8, 8, 8, 14, 14, 14, 14,
    8, 8, 8, 8, 8, 8, 8, 8, 8, 8, 6, 8, 8, 8, 8, 8, 6, 0, 1, 6, 8, 8, 8, 8, 8, 6, 8, 8, 8, 8, 8, 8, 8, 8, 8, 8, 14, 14, 14, 14
  ],
  "tags": ["city"],
  "connection": {
    "south": 17,
    "west": 18,
    "north": 17,
    "east": 20
  },
  "start_x": 17
}
